30
########
#G    A#
#      #
#      #
#      #
#      #
#P SL  #
########
