30
#########
#P #  A #
#  #  G #
#  #    #
#  # N  #
#       #
#  SL   #
#########
